000000000
000000000
0ff000000
000000000
00000ff00
000000000
0ff000000
000000000
00000ff00
000000000
0ff000000
000000000
0000ff000
000000000
000000000
fffffffff

000000000
0000000ff
0ff000000
000000000
00000ff00
000000000
0ff000000
000000000
00000ff00
000000000
0ff000000
000000000
0000ff000
000000000
000000000
00000ffff