000000000
000000000
0ab000000
000000000
00000ab00
000000000
0abc00000
000000000
00000abc0
000000000
0ab000000
000000000
0000ab000
000000000
000000000
abcdefgab

000000000
0000000ab
0ab000000
000000000
00000ab00
000000000
0ab000000
000000000
000000a00
000000000
0ab000000
000000000
0000ab000
000000000
000000000
00000abcd

000000000
0000000ab
0abc00000
000000000
000abcdef
000000000
0abcde000
000000000
000000abc
000000000
0ab000000
000000000
0000ab000
000000000
000000000
abcd00000

000000000
0000000ab
0a0000000
000000000
00000a000
000000000
0abc00000
000000000
000000a00
000000000
0abcd0000
000000000
0000abcd0
000000000
000000000
0abcd0000

000000000
00000000a
0a0000000
000000000
00000abcd
000000000
0abc00000
000000000
000000000
000000abc
000000000
000000000
00ab00000
0000000a0
000000000
000d00000